4 3
    1    1    1   2
    1    0    1   2
    1    1    1   1
 
  -50  -50  -50 100
  -50    0  -50 -80
  -50  -50  -50 -50